..................................................
.##...#..#################...###..................
.#....#..#################...###..................
.#....#..#################...###..................
.#########################...###....#.............
.########.################...###....#.............
.#####.###################...###....#.............
.#########################...###....#.............
.####################################.............
.#########################...###....#.............
.##.#####..###############...###..................
.########..###############...###..................
.#########################...###..................
.......#..........................................
.......#..........................................
.########################.........................
.########################.........................
.########################.........................
.......#..........................................
.......#..........................................
.......#..........................................
.......#..........................................
......#########...................................
..................................................
..................................................
..................................................
..................................................
..................................................
..................................................
..................................................
..................................................
..................................................
..................................................
..................................................
..................................................
