..................................................
.##...####################...###..................
.#....####################...###..................
.#....####################...###..................
.#########################...###....#.............
.#########################...###....#.............
.#########################...###....#.............
.#########################...###....#.............
.####################################.............
.#########################...###....#.............
.#########################...###..................
.#########################...###..................
.#########################...###..................
.......#..........................................
.......#..........................................
.########################.........................
.########################.........................
.########################.........................
.......#..........................................
.......#..........................................
.......#..........................................
.......#..........................................
......#########...................................
..................................................
..................................................
..................................................
..................................................
..................................................
..................................................
..................................................
..................................................
..................................................
..................................................
..................................................
..................................................
